
Привет на Азербайджанском - Salaam aleihum
Привет на Албанском - Tungjatjeta
Привет на Английском - Hello
Привет на Арабском - Ahlen
Привет на Арабском - Marhaba
Привет на Армянском - Voghdzuyin
Привет на Ассирийском - Shlama
Привет на Африкаанском - Goeie dag
Привет на Башкирском - Kheyerle irte
Привет на Белорусском - Прывитанне
Привет на Бенгальском - Nomoskaar
Привет на Болгарском - Zdraveite
Привет на Боснийском - Zdravo
Привет на Гавайском - Aloha
Привет на Голландском - Hallo
Привет на Греческом - Geia sou
Привет на Грузинском - Gamardjobat
Привет на Датском - God dag
Привет на Еврейском - Shalom
Привет на Египетском - Iiti
Привет на Зулу - Sawubona
Привет на Ингушском - Salam
Привет на Индонезийском - Selamat
Привет на Исландском - Godan daginn
Привет на Испанском - Hola
Привет на Итальянском - Buon giorno
Привет на Казахском - Salam
Привет на Калмыкском - Mendvt
Привет на Каракалпакском - Assalomu alaikum
Привет на Карельском - Terveh
Привет на Киргизском - Salaam matszbe
Привет на Кирибати - Mauri
Привет на языке индейцев Команче - Haa
Привет на Корейском - Annyoung hasimnikka
Привет на Корякском - Mej
Привет на Кхмерском - Sok sabai jie te
Привет на Латинском - Ave
Привет на Латышском - Sveiki
Привет на Литовском - Sveikas
Привет на Люксембургском - Moien
Привет на Македонском - Zdravo
Привет на Мордовском - Shumbrat
Привет на Зимбабвийском - Sawubona
Привет на Немецком - Guten Tag
Привет на Норвежском - Goddag
Привет на Польском - Dzien dobry
Привет на Португальском - Ola
Привет на Прусском - Kails
Привет на Румынском - Buna
Привет на Сербском - Zdravo
Привет на Сицилийском - Sa’benerica
Привет на Словацком - Dobry
Привет на Тайском - Sawatdi
Привет на Татарском - Isenmesez
Привет на Тибетском - Kam sangbo dugay
Привет на Турецком - Merhaba
Привет на Удмуртском - Ziech bures
Привет на Узбекском - Salaam aleikhem
Привет на Украинском - Прывит
Привет на Уэльском - Dydd da
Привет на Финском - Paivaa
Привет на Французском - Bonjour
Привет на Хинди - Namaste
Привет на Хорватском - Zdravo
Привет на Чеченском - Marsha voghiila
Привет на Чешском - Dobry den
Привет на Чувашском - Salam
Привет на Чукотском - Ye’ti
Привет на Шведском - God dag
Привет на Шотландском - Guid mornin
Привет на Эсперанто - Saluton
Привет на Эстонском - Tervist
Привет на Японском - Konnichi wa
Привет на Падонском (Язык Рунета) - Превед